1111111111111111
1000000000000001
101C000000000001
1000000000000001
1000P00000000001
1000000000000001
1010000000000001
1000000000000001
10000000E0000001
101C000000000001
1000000000000001
1111111111111111